1111111111111111111111111111111
10P0000001000000000000000100001
100000000100000ZZ0000000000E001
10000CCCCCCC0000000000000111111
10000000010000000000Z0000000011
1000000001000CC00000000000Z0001
100000000000000000Z000010000001
1111111111111111111111111111111