1111111111111111111111111111111
10P0000001000000000000000100001
1000000001000000000000000Z0E001
10000CCCCCCC0000000000000111111
10Z000000100Z0000000Z0000000011
1000000001000CC0000000000000001
1000000000000000000000010000001
1111111111111111111111111111111