1111111111111111111
1P00x0Z1000Z000r001
111100011f001111111
1000000000000000001
10f0x0011100011Z0f1
1000010001f00100001
1000010001000110001
1000100Z000Z0010001
100f111111f1111E011
1111111111111111111