1111111111111111111111111111111
10P0000001000000000000000100001
1000C00001L0000Z00000000000E0C1
100000000Z000000000000000111111
10000000010C00000000Z0000000011
10000Z000100000000C000000000Z01
10C00000000C00000000000100000C1
1111111111111111111111111111111