1111111111111111111
1P00C001000Z000C001
111100011C001111111
1000000000000000001
10C0Z0011100011Z0C1
100Z010001C00100001
1000010001000110001
1000100Z000Z0010Z01
100C111111C1111E011
1111111111111111111